%%%...%%%%%%%%....%%%%%%%%%%%%%%%%%%%%....%%.....%%...%%%....%%%....%%%%%%%%...%%%%%%%%%%%%%%%%%%%%%%%%%%%%%%%%%%%%%%.....%%....%....%....%%%..
%%.....%%%..%%....%.%%%%%%%..%%%%....%....%%%...%%%.........%.%%...%.%.%%%%%...%..%%.%.%%%.....%%.%.%.%%...%..%.....%.....%.....%....%.....%%..
B%%.........%%................%%...........%.....%..........%............%%...............................................%%....%....%%........
.%%..........%................%%...........%%....%%.......................%...............................................%....%%....%%........
%%%..........%%...............%%...........%%....%%.......................%%.............................................%%....%%....%%........
%%%.%%%.%....%%%%.%%%.%%%%%...%%....%.%.%.%%.....%%....%.%%.%%%.....%....%%%%%.%%....%.%..%.%...%.%%.%%.%%%.%.%..%...%.%.%%....%%....%%.%.%%.%.
%%%%%%%%%....%%%%%%%%%%%%%....%%%...%%%%%%%%....%%....%%%%%%%%%%....%.....%%%%%%%%%%%%%%%%%%%%%%%%%%%%%%%%%%%%%%%%%%%%%%%%%....%%....%%%%%%%%%%
%.%...%%.....%.%..%%.%.%%%....%.%...%%%%%.%%%...%%....%.%%%%%%%.....%%....%%.%...%%%.%%...%..%.%%%%%.%..%.%.%%%.%%%.%......%....%...%.........%
......%%................%%..........%%%..........%.................%%.....%......................%%%..............B............%%..............
......%%................%%%..........%%.........%%%.................%%...%%%.....................%%.............................%..............
......%%%................%%.........%%..........%%..........%......%%%...%%%.....................%%%...........................%%..............
%%%....%%.%%%.%%...%%....%%%%.%.%...%%%...%%%..%%%%.%%.%%......%...%%%%..%%....%%.....%.%..%.%%..%%......%...%.%....%.%..%......%...%.%.%.%....
%%%...%%%%%%%%%%%%%%%....%%%%%%%%%%%%%%....%%%%%%%%%%%%%%....%%.....%%%%%%%%....%%....%%%%%%%%%%%%%.....%....%%%...%%%%%%%%....%%....%%%%%%%%..
%%%...%%%..D%%%..%.%%...%%%.%..%.%%.%%%....%%%..%...%%%%%...%......%%%...%%%...%%.....%..%.%%.%...%....%%....%%.....%%%%%%%....%%....%%.%%%.%..
.%..........%%%..........%%...............%%%..........%.......................%%%......................%%....%..%%...%%%.%%%.%C....%%%........
%%%..........%..........%%%................%%..........%.......%...............%%%......................%............................%%.....D..
.%%.........%%..........%%%...............%%..........%%.......%...............%%......................%%%...........................%.........
%%%%%%...%%.%%%...%%%...%%%.%.......%%.%.%%%%.....%.%%%%%....%%%...%.....%..%..%%%..%%.%%.%%%..%%%%%...%%............................%%...%%.%%
%%%%%%%%%%%%%%%...%%%%%%%%%%%%%%.....%%%%%%%....%%%%%%%%%....%%%...%%%....%....%%%....%%...%%%%%%%%%...%%.....%.%.%..%.%.%%%....%%...%%....%%%%
%%%%%.%%...%.......%%%.%.%%%%.%......%%%....%......%.%%.%...%%......%%....%....%%%...%%....%%%%%%%%....%%%....%%%%%%%%%%%%%.....%%...%%....%%..
.%................%%.................%%.............................%%%%...%....%....%%%...%%%.%.%..%...%%....%%.%.%%...%%.%...%%%....%........
.%%................%%...............%%......................................................%................%%.................%%.............
%%.................%%................%......................................................%%...............%%................%%..............
%%%...%.%%...%%.%.%%....%%...%..%.%.%%%...%%%....%....%...%%%%.............................%%.................%%................%..........%...
%%.....%%%%%%%%%%%%%....%%%....%%%%%%%%....%%...%%%....%....%%......%%...%.%%.%......%....%%%......%.%%%%.%.%%%.......%...%%.%%%%%%..%%....%%..
%%....%%%.%.%..%.%.%.....%%...%%%%%%%%%...%%....%%%....%....%%%...%%%....%%%%%%%%%....%%%%%%%.....%%%%%%%%%%%%%%...%%%%%%%%%%%%%%%%%%%%....%%..
.........................%%...%%%%%..%%%.%%.%%..%%%..%..%.....%...%%%....%%%%%.%.....%%%%.%.%%.......%.%%%...%%%...%%%.%%...%%%%%%.%%.%%...%%..
........................%%%......................%%...............%.......%%..........%%...............%%%..........%%.........%%...........%..
.........................%......................%%%...............%.......%..........%%................%%%..........%..........%%%...C.....%%..
..D%.%%%.%%%...%%..%....%%......................%%%.......................%..........%%%...............%%..........%%%..........%..........%%%.
.%%....%%%%%%%.....%%....%%....%...%.%%.%..%.....%%...%%%...%%%......%...%%%%%...%..%%%....%%%.%%.%..%.%%%...%%.%..%%%C..%%%...%%%...%.%%%.%%..
.%%....%%%%%%%%...%%%....%.....%%%%%%%%%%%%%....%%....%%%%%%%%.....%%....%%%%%%%%%%%%%%....%%%%%%%%%%%%%%....%%%%%%%%%%%%%%%...%%%...%%%%%%%%..
.%......%..%.%....%.%...%......%%..%%.%..%.%.....%%....%%..%%%%...%......%%.%%.%%%%..%%%...%%%...%.%.%%%%....%%...%%.%%%.%%....%%%.....%.%.%.%.
.%%...........................%%%.....................%%%...%%%......%..........%%..........%%.........%%................%%%...................
.%.............................%%.....................%%%...%%.................%%%.........%%..........%%%................%%...................
.%%............A..............%%%......................%.....%%.................%..........%%%..........%%................%%...................
.%....%......%.%%%.%%%.%.%..%.%%%%%.%..%...%%.%%%...%.%%....%%.....%%%%%%%.%....%%...%%%.%%%%%...%.%....%%%.%.%%..%.%.....%%...%.%.%.........%.
.%%....%%%%%%%%%%%%%%%%%%%%%%%%%%%%%%%%%%%%%%%%%%%%%%%%%.....%....%%%%%%%%%%....%%....%%%%%%%%...%%%....%%%%%%%%%%%%%....%%%%%%%%%%%%%%%%%%%%..
.%%....%%.%.%...%..%.%.%%%.%%.%%.%...%.%..%.%....%%.%%%%%....%.....%%%.%%.%....%%.....%%.%.%.%....%%...%%%%%.%%%.%%%%....%.%%%.%%%..%.%%.%.%%..
.%%....%%.............................................%%.......................%%....%%...........%%...............%%..........%%%.........%%..
.%%....%...............................................%.......................%%....%%...........%%................%..........%%..........%%..
.%....%%...............................................%%............%..........%.....%...........%%................%%.........%%A.........%%..
.%.....%.....%.....%..%...%%.%.%.%%.....%%%.%.%%..%...%%%%%.%.%...%%.%.........%%%...%%%....%....%%%%..%%%%%%%.%....%%..%%%.....%%...%%.....%..
.%....%%.....%%%%%%%%%%%%%%%%%%%%%%%%%%%%%%%%%%%%%%...%%%%%%%%....%%%....%%%...%%.....%%....%%%%%%%%%%%%%%%%%%%%....%%%%%%%%...%%%...%%%....%..
.%%...%%%...%%%%..%..%%%.%..%%.%%...%%%..%%%%...%%%...%..%.%%%....%.%%....%.....%%...%%%........%%....%%.%%%%%%%...%.%..%%%.....%%...%%%.....%.
.............%.......................%...........%..........%%.......%....%%....%....%%%......................%...........%.....%.....%........
............%%%......................%%.........%%%..........%...........%%.....%....%%.......................%...........%.....%%...%%%.......
............%%.......................%%..........%%.........%%%......%....%....%%%....%.......................%..........%%....%%%....%........
%.....%%%%%.%%.....%%%.%%%%..%%......%%.........%%%%%.%%%....%%%..%%%%...%%%....%.....%%.%%%..%..%.%%.%%%.....%%%.%%......%%....%%...%%%%%%.%..
%%%....%%%%%%%%....%%%%%%%%%%%%%.....%.....%%....%%%%%%%%...%%%%%%%%%%...%%.....%%....%%%%%%%%%%%%%%%%%%%%...%%%%%%%%%....%%....%%%%%%%%%%%%%%%
.%.....%%%..%%....%...%.%..%.%.%.....%.....%....%%%%.%%%%...%...%.%%%.....%%...%%.....%%......%..%%%%%..%%...%....%%%%...%%%.....%%%%%%.%%..%.%
.%.....%%...........................%%%....%...........%...........%%....%%%....%.....%..........%%.................%%....%....................
.%....%%.............................%.....%...........%%.........%%%%....%....%%....%%..........%%.................%%...%%....................
.%%....%.............................%....%%...........%%..........%%%....%....%%%...%%...........%%...............%%%...%%....................
.%%...%%....%%......%%%%.%..%.%.%.%%%%%...%%%....%%...%%..........%%%%....%%%%%%%.....%%.........%%%...%.....%%..%%%%%...%%%...%%.%.%%.%%%..%..
.%%...%%.....%%...%%%%%%%%%%%%%%%%%%%%.....%%%%%%%.....%%....%.....%%%...%%%%%%%%%...%%%....%%....%%...%%%%%%%%%%%%%%%...%%....%%%%%%%%%%%%%%..
.%%.........%%.....%%%.%.%..%%.%%%..%%%....%%%%%%%%...%%.....%%.....%%......%.%%%%....%....%%....%%.....%%%%%..%..%%%....%%%...%%%%.%%%....%.%.
.%...........%%....%%...............%%%....%%..........%.....%....%.............%....%%%...%%%....%%...%%%................%....%%%.............
.%...........%%...%%%...............%%.....%..........%%%...%%%................%%%....%%....%....%%%....%%...............%%....%%..............
.%%..........%%...%%%................%%...%%..........%%.....%%.................%%...%%.....%%....%....%%.C...............%%...%%..............
%%%..%%..%..%%.....%%.....%%.%.%%....%%...%%%...%...%%%%%%%%%%%....%%%%..%......%....%%....%%.....%....%%%.%%%.....%.%%%%%%%%%.%%....%.%%..%.%%
%%%%%%%%%%%%%%%....%%....%%%%%%%....%%%....%%...%%%%%%%%%%%%%%%...%%%%%%%%%....%%%....%%...%%....%%%....%%%%%%%%%%%%%%%%%%%%%%%%%.....%%%%%%%%%
%%%%.%%%%....%....%%%....%%.%%%%....%%....%%%...%%%%%...%.%%%%....%%..%.%..%....%%....%....%%%....%.........%.%..%%.....%%..%%.%%....%%%%..%%%%
......%%...........%%....%.A..%%..........%%%...%%%..........%%................%%%....%%...%%....%%%...........................%%%...%%........
.......%%.........%%.....%%...%%..........%%%...%%...........%..................%....%%%....%%...%%............................%%%....%%.......
.......%%..........%%...%%%...%%..........%%%....%%..........%%................%%%....%%...%%....%%%...........................%%%....%........
...%..%%%...%%..%.%%.....%%....%%...%%....%%%...%%....%%%...%%%.%%.......%%%...%%.....%....%%....%%%%%%%%%%.%.%.%..%.%%.%.%.....%....%%%.......
.C%%%%%%%...%%%%%%%%%...%%.....%%....%%%%%%%....%%%...%%%...%%%%%%%%%...%%%....%%%...%%....%%.....%%%%%%%%%%%%%%%%%%%%%%%%%%...%%....%%....%%..
....%%%%%....%%.%%%%.....%....%%.....%%...%%%...%%%....%....%%.%..%%......%%....%.....%%.....%....%..%%..%.%.%%%...%%%%%.%%%...%.....%%%...%...
.......%.....%.....%%....%.....%.....%%..........%.....%%..........%%..........%%.....%.......................%%.........%%...........%........
.......%.....%%....%....%%.....%%....%..........%%.....%..........%%....%......%%%....%......................%%%..........%%..........%........
......%%....%%.....%....%%....%%%...%%%.........%%%...%%...........%%...%.....C%%.....%%......................%...........%%..........%%.......
%%%....%%...%%%...%%%....%%...%%%%..%%%...%....%%%....%%%%..%%....%%......%.....%.....%%.%..%.....%.%%%.%.....%%.%.%%....%%%%%.%%.%..%%%....%%.
%%%....%%...%%%...%%.....%....%%%%%%%%.....%%%%%%%%....%%%%%%%....%%.....%%%...%%....%%%%%%%%%...%%%%%%%%%...%%%%%%%%....%%%%%%%%%%%%%%....%%%%
.%....%%%...%.....%%%....%%....%%%%%%%....%%%%........%%%%.%%%.....%%....%%.....%%.....%.%%%%%...%.%...%%....%%...%%%%...%%..%..%%..%%%%...%%.%
......%%%.........%%%....%%................%..........%%A....%%....%....%%%%....%...........%...........%............................%%....%...
.......%..........%%.....%%................%..........%%....%%.....%%...%%%.....%%.........%%...........%............................%%....%...
.......%%..........%%...%%%...............%%%..........%....%%....%%....%%%.....%..........%%%.........%%.............................%....%%..
.......%%...%%%..%%%....%%%.%.%%%%%.%..%..%%%...%%...%%%%....%....%%%....%%%....%%%....%...%%%%.........%%.%%%%%...%%%%.%%%..%%..%...%%....%%..
%%%....%%...%%%%%%%%%....%%%%%%%%%%%%%%%%%%%%....%%%%%%%%....%%....%%...%%%.....%%%%%%%%...%%%%%%%%.....%%%%%%%%%%%%%%%%%%%%%%%%%....%%....%...
%%.....%.....%%%%.%%.....%%%..%.%...%%%....%....%%%%%%.%%....%%...%.%...%......%....%.%%...%...%.%%....%%%%..%%%..%..%%.....%.%%%%...%%....%%..
.%%...%%.....%%.........%%%.....................%%..........%%..........%..............................%%%....%%................%..........%%..
%%.....%%...%%%.........%%%.....................%%..........%%%.........................................%.....%%...............%%..........%...
%%....%%%....%...........%.......................%..........%%%.........%...............................%%...%%.................%%.........%%..
%%%.%.%%.....%%...%%.%%%%%%%%%%%%......%...%.%%%%%%...%%%.%%%%%.%.%.....A%%.%.%.%%%%...%....%...%%%%..%%%%....%....%%.....%.%..%%......%...%...
%%%%%%%%....%%%....%%%%%%%%%%%%%%....%%%%%%%%%%%%%....%%%%%%%%%%%%%%%....%%%%%%%%%%%%%%%....%%%%%%%%%%%%%%....B....%%%....%%%%%%%....%%....%...
...%..%.%...%%.......%%%.....%%%....%%%%%.%%%D.%%%%...%%%.%.%%%..%%%%......................%%..........%%%.........%%.....%%.%%%%....%.........
.............%%...............%%%...%%...........%...........%%.............................%..........%%%.........%%..........................
.............%.................%....%%...........%%.........%%..............................%%.........%%%..........%%.........................
............%%................%%%...%%..........%%..........%%..........%..%...%.......%....%......%...%%%.........%%..........................
%%....%%%.%%%%%...%%%..%%.%...%%%...%%%.%.%%%....%.....%%.A..%%....%%%%%%%%.....%%%%%%%....%%%...%%.....%%....%....%%%..%%.%%.%.......%..%.%...
.%....%%%%%%%%%%%%%%%%%%%%....%%....%%%%%%%%%...%%.....%....%%%...%%%%.%%%%%....%%%%%.......%.....%%...%%%....%%....%%%%%%%%%%%%%....%%%%%%%%..
..%.........%.%%..%.%.%.%%%....%%....%%.%.%%....%%....%%%...%.............%.....%..........%%.....%.....%.............................%%%%%%...
........................%%%....%%...%%%..........%.....%%................%%%....%%.........%%%...%%.....%............................%%%%%%%...
.........................%.....%%...%%%.........%%....%%%................%%.....%..........%%%...%%....%%%............................%%%%%%%..
.........................%.....%.....%%..........%.....%.............%...%%%....%%....%%.%.%%....%%....%%%.%.%.%..%%.%.........%......%%%%%%...
.%%%%%%%%%%%%%....%%....%%%...%%.....%.......%%%%%....%%%%%.%%%%...%%%....%.....%%...%%%%%%%%%....%%....%%%%%%%%%%%%%%%%%%%%....%....%%%%%%%%..
...%.%%.%%..%%%....%....%%.....%%...%%%....%%%%%%%.....%%%%%%%%....%%..B.%%.....%....%%%.%.%%%...%%%...%.%%..%%%...%%%%%.%%%....%%....%.%..%...
.............%%.........%%%...%......%....%.......%...%..%..........%%..........%%..........%%...%%%................%%.........................
............%%..........%%%.........%%..............................%%.........%%...........%%....%.................%..........................
.............%%.........%%%..........%.............................%%...........%...........%%...%%%...............%%..........................
.%%%%.%%.....%%.........%%%..........%%......................%%%%..%%%.%.%%%...%%%%.C%%%.%%%%%....%%%.....%%%.......%%...%.%..%.............%..
.%%%%%%%....%%%....A....%%%%%%%%%%%%%%....%%%%%%%%%%%%%%%....%%%%%%%%%%%%%%%....%%%%%%%%%%%%%....%%%%%%%%%%%%%%....%%%....%%%%%%%%....%....%%..
.%%..%.%.....%%....%....%%%%..%%%%...%....%...%%%%.%.%.%%B.....%.%.%%%%%.%%%...%%%%%%.%...%......%%%%%%%%%%%%.%%...%%.....%%.%.%%%....%...%....
%%.................%%...%%...............................%.........%%%..........%.......................%...........%....%%%....%%...%%........
.%%...............%%.....%.........................................%%%..........%%.....................%%%.........%%%...%%.....%%....%........
.%................%%....%%%..............................%..........%%..........%%.....................%%%.........%%.....%%...%%....%%........
%%%%.%.....%%..%..%%%..%%%%....%%.%...%...%%.%....%......%...%.%...%%....%%.%%%%%%....%....%%%...%.%..%%%.....%%.%%%%.....%.....%%...%%....%%..
.%%%%%%%%%%%%%%%%%%%%%%%%%.....%%%%%%%%...%%%%%%%%.....%%%...%%....%%....%%%%%%%%....%%%%%%%%%%%%%%%%%%%%....%%%%%%%%%...%%....%%%....%....%%..
%..%%..%%%.%%%%...%%%%%.%%.........%%%%...%....%%%....%%%....%%%....%....%%%%...%%...%%%..%..%.%%%%%.%.%%%....%%%..%%%...%%..........%%....%%..
.........................%%.........%%%..........%.....%%%....%%....%%....%..........%%%...............%%%...%%..........%%..........%%....%...
.........................%...........%%.........%%.....%%%...%%.....%%....%%..........%................%%.....%%..........%...........%....%%..
.........................%...........%...........%....%%%%....%....%%....B%%..........%................%%....%%%.........%%%..........%....%%..
%%..%..%%...%%%%...%%....%%...%.%...%%%%%.%.....%%.....%%....%%.....%%%.%%%%........%%%%....%%%%%%%....%%....%%%.....%...%%%....%..%.%%...%%%%.
%%%%%%%%%....%%%%%%%%...%%%%%%%%%...%%%%%%%%%....%%...%%%.....%%....%%%%%%%....%%%%%%%%.....%%%%%%%%....%.....%%...%%%...%%....%%%%%%%%....%%%%
.%%.%%%%%....%%.%.%%.....%.%%%.%.....%..%.%%.....%.....%......%%....%%..%%%%....%%%....%...%%%..%%%%...%%....%%%...%%%...%%....%%%%.%%....%%%..
......%%...........%......................%%.....%%D.....%...%%...........%%...%%%.........%%%...%%%....%%....%.....%%....%%..............%%...
......%%..........%%%......................%....%%%......%....%%..........%.....%%..........%....%%.....%%....%....%%.....%................%...
.......%%.........%%.......................%.....%%..........%%..........%%.....%..........%%.....%.....%....%%.....%.....%................%...
..%...%%%.%%%%%...%%%.%.%..%%..%....%.....%%.....%....%%......%%..%.%%....%....%%%...%%%...%%.....%%....%.....%%%%.%%....%%%%%........%...%%%..
.%%...%%%%%%%%%%%%%%%%%%%%%%%%%%.....%%....%%...%%%....%%%...%%%%%%%%%...%%%...%%%....%%%%%%%....%%.....%%...%%%%%%%%%...%%%%%%%D....%%....%%..
.%.....%.%.%%.%..%.%.%.%%%%%%%%%%....%%....%.....%%...%%%.......%%.%%%...%%%....%%...%%%....%%...%%....%%.....%%.%..%%...%%%..%...........%%%..
%%%...........................%%%....%%...%%....%%%................%%..........%%....%%%..........%%...%%%...%%..........%%................%...
%%%............................%%...%%....%%%....%..................%...........%%...%%%..........%%...%%.....%%.........%%...............%%...
%%%...........................%%%....%%...%%....%%%................%%..........%%%...%%%..........%%..B.%....%%...........%%...............%%..
.%%.%%..%%.....%%..%.%.........%....%%%....%....%%....%..%.%..%%....%%%%.%...%%%%%...%%%....%%....%%%%.%%....%%%....%....%%%%.%%%%%%%%%..%%%%..
.%%%%%%%%%%%%%%%%%%%%%%%%%....%%%....%%...%%....%%%....%%%%%%%%%...%%%%%%%%%%%%%%%...%%....%%%....%%%%%%%....%%....%%%%%%%%%%%%%%%%%%%%%%%%%...
.%%.%%%%%%%%%.%.....%%%.%%%....%.....%%....%%....%......%..%%%%....%%%%%%%%%%%...%...%%%...%%....%%.%.%%.....%%.....%%..%..%%..%%%%%%.%..%%.%..
.%%...%%...............D.%%....%....%%.....%%...%%.................%%.....%%..........%%...%%................%%%...%%..........%%..............
.%%....%%...............%%....%%%....%....%%....%%%................%%%...%%%..........%.....%%...............%%%...%%...........%..............
%%%....%................%%%...%%....%%%...%%%....%.............%....%.....%..........%%....%%%...............%%....%%...........%..............
%%%...%%%....%%%..%..%%%%%.....%%....%%....%....%%%%.%......%%.....%%.....%%...%%%%%%%%....%%%..%%%.%%..%.%.%%%.....%%.........%%...%.%....%%%.
%%%....%%...%%%%%%%%%%%%%%%...%%....%%....%%%...%%%%%%%%%...%%%.....%....%%.....%%%%%%%.....%%%%%%%%%%%%%%%%%%%%...%%.....%%...%%....%%%%%%%%%%
.%%...%%%...%%%%%..%%.....%...%%%.........%%.....%%%%%%%....%%%%..........%%...%%....%%%...%%%%%.%.%.%..%.%%%%......%%....%%...%%....%..%%%.%%.
.......%%...%%%...............%%...........%%...%%%....%....%%%..........%%...........%%....%.............................%....%%..............
.......%%...%%.................%%..........%%....%%....%....%%%%.........%%...........%.....%.............................%%....%..............
.......%....%%.................%%..........%.....%....%%%....%%...........%...........%....%%%...........................%%.....%..............
%.....%%%...%%%%....%...%%..%%%%%..%......%%.....%%...%%.....%%%.%...%...%%%%.%%%%....%.....%.....%.%.%..%.%...%....%%..%%%.....%..%.%..%%.%%%%
%%....%%....%%%%%%%%%...%%%%%%%%%%%%%%%%%%%%....%%.....%%...%%%%%%%%%%...%%%%%%%%....%%.....%.....%%%%%%%%%%%%%....%%%%%%%%....%%%%%%%%%%%%%%%%
%%....%%......%%.%%%.....%%%.%%.%..%..%%%.%%.....%....%%%...%%%%..%%%....%%%.%%%%%.........%%......%%..%%%%.%%%.....%%.%%%%%.....%...%.%%%%%%..
%%%....%%..........%.......................%....%%%....%....%......%%%.........%%..........%%.......................%%.....................%...
%%.....%...........%.......................%%....%.....%%...........%..........%%%.........%%......................%%%....................%%%..
.%.....%...........%......................%%%....%....%%....%.......%%..........%...........%.......................%......................%...
